Tracey	Walker
Bella	Powell
Karen	Walsh
Lisa	Knox
Eric	Sharp
Adrian	Walker
Vanessa	Sharp
Keith	Payne
Melanie	Lambert
Wanda	Forsyth
Anna	Rampling
Samantha	Mackenzie
Diane	Ogden
Isaac	Paterson
Wendy	Lawrence
Natalie	Reid
Joan	Lyman
Victor	Mackenzie
Penelope	Hart
Jan	Howard
Michelle	Reid
Kevin	Terry
Bella	Sharp
Gabrielle	Mackay
Alexandra	North
Adam	Poole
Brandon	Harris
Kevin	Cameron
Pippa	Morgan
Hannah	Reid
Oliver	Fraser
Mary	Peters
Penelope	Mitchell
Dorothy	Wright
Anna	Glover
Max	Coleman
Boris	Lambert
Nicholas	Cornish
Tim	Thomson
Keith	Dickens
Gordon	Morgan
Owen	Scott
Benjamin	Duncan
Nicholas	North
Jake	Walker
Alison	Chapman
Harry	Anderson
Liam	Hardacre
Harry	Allan
Peter	Mills